a la carte	phó từ - theo món, gọi theo món, đặt theo món -to dine a_la_carte: ăn cơm gọi theo món
a la mode	phó từ - hợp thời trang, đúng mốt
a.m	(vt)(radio)viết tắt của amplitude modulation) biến điệu biên độ - (vt của Master of Arts) cao học văn chương - (vt của tiếng Latinh Antemeridian) sáng, trước ngọ
a.m.	phó từ - (xem) ante_meridiem
a-ok	tính từ - giống như OK nhấn mạnh
a-pac-thai	danh từ - apartheid
a-plenty	phó từ - (từ Mỹ,nghĩa Mỹ) nhiều, dồi dào, phong phú
a-point	(giải tích) a- điểm
a posteriori	phó từ &amp; tính từ - theo phép quy nạp -method a_posteriori: phương pháp quy nạp - hậu nghiệm -probability a_posteriori: (toán học) xác suất hậu nghiệm
a-power	danh từ - năng lượng nguyên tử - cường quốc nguyên tử
a priori	danh từ &amp; phó từ - theo cách suy diễn, theo cách diễn dịch - tiên nghiệm -probability a_priori: (toán học) xác xuất tiên nghiệm
a-road	danh từ - đường lớn, không quan trọng bằng xa lộ, nhưng rộng và thẳng hơn đường loại B
a.s.a.p.	(viết tắt) - càng sớm càng tốt (As soon as possible)
A shares	(Econ) Cổ phiếu A.(Cổ phiếu hưởng lãi sau). -+ Xem FINANCIAL CAPITAL.
a-side	danh từ - mặt chính của dĩa hát
A W O L	tính từ - (quân sự) nghỉ không được phép, nghỉ không xin phép
A4-size	(Tech) khổ giấy A4 (21 cm x 29.7 cm)
aa	(Alcoholics Anonymous) Hội cai rượu - (Automobile Association) Hội ô tô
aaa	(Amateur Athletic Association) Hội thể thao không chuyên - (American Automobile Association) Hiệp hội xe hơi Mỹ
aard-wolf	danh từ - (động vật học) chó sói đất (Nam Phi)
aardvark	danh từ - (động vật) lợn đất
aardvarks	danh từ - (động vật) lợn đất
aardwolf	danh từ - chó sói đất (Nam Phi)
aardwolves	danh từ - chó sói đất (Nam Phi)
aasmus	(y học) bệnh hen
aasvogel	danh từ - (động vật học) con kên kên (Nam Phi)
ab	(vt của able-bodied seaman) thủy thủ hạng nhất - (vt của Bachelor of Arts) Cử nhân văn chương
aba	danh từ - áo aba (áo ngoài giống hình cái túi người A-Rập)
abac, abacus	bàn tính, toán đồ, bản đồ tính
abaca	danh từ - vải dệt bằng tơ chuối abaca ở philipin - cây chuối abaca
abaci	danh từ, số nhiều abaci, abacuses - bàn tính -to move counters of an abacus; to work an abacus: tính bằng bàn tính, gảy bàn tính - (kiến trúc) - đầu cột, đỉnh cột
abacist	danh từ - người gãy bàn phím - người kế toán
aback	phó từ - lùi lại, trở lại phía sau -to stand aback from: đứng lùi lại để tránh - (hàng hải) bị thổi ép vào cột buồm (buồm) -to be taken aback: (hàng hải) bị gió thổi ép vào cột buồm - (nghĩa bóng) sửng sốt, ngạc nhiên -to be taken aback by the news: sửng sốt vì cái tin đó
abacterial	tính từ - không do vi khuẩn gây ra
abactio	(y học) sự phá thai
abaction	danh từ - (từ pháp) việc gia súc bị bắt trộm
abactus	tính từ - bị trụy thai
abacus	danh từ, số nhiều abaci, abacuses - bàn tính -to move counters of an abacus; to work an abacus: tính bằng bàn tính, gảy bàn tính - (kiến trúc) - đầu cột, đỉnh cột
abacuses	danh từ, số nhiều abaci, abacuses - bàn tính -to move counters of an abacus; to work an abacus: tính bằng bàn tính, gảy bàn tính - (kiến trúc) - đầu cột, đỉnh cột
abaddon	danh từ - âm ti, địa ngục - con quỷ
abaft	phó từ - (hàng hải) ở phía sau bánh lái, gần phía bánh lái - giới từ - (hàng hải) sau, ở đằng sau, ở phía sau -abaft the mast: sau cột buồm
abalienate	ngoại động từ - nhường lại tài sản
abalienated	ngoại động từ - nhường lại tài sản
abalienates	ngoại động từ - nhường lại tài sản
abalienating	ngoại động từ - nhường lại tài sản
abalienation	danh từ - sự nhường lại tài sản
abalone	danh từ - (từ Mỹ,nghĩa Mỹ) bào ngư
abalones	danh từ - (từ Mỹ,nghĩa Mỹ) bào ngư
abampere	(Tech) abampe, ampe tuyệt đối (đơn vị cường độ tuyệt đối của dòng điện, 1 abampe = 10 ampe)
abandon	ngoại động từ - bộm (nhiếp ảnh) (nhiếp ảnh) (từ Mỹ,nghĩa Mỹ) từ bỏ; bỏ rơi, ruồng bỏ -to abandon a hope: từ bỏ hy vọng -to abandon one's wife and children: ruồng bỏ vợ con -to abandon oneself to: đắm đuối, chìm đắm vào (nỗi thất vọng...) - danh từ - sự phóng túng, sự tự do, sự buông thả -with abandon: phóng túng
abandon call	(Tech) gọi bỏ
abandoned	tính từ - bị bỏ rơi, bị ruồng bỏ - phóng đãng, truỵ lạc
abandoner	danh từ - (pháp lý) người rút đơn
abandoners	danh từ - (pháp lý) người rút đơn
abandoning	ngoại động từ - bộm (nhiếp ảnh) (nhiếp ảnh) (từ Mỹ,nghĩa Mỹ) từ bỏ; bỏ rơi, ruồng bỏ -to abandon a hope: từ bỏ hy vọng -to abandon one's wife and children: ruồng bỏ vợ con -to abandon oneself to: đắm đuối, chìm đắm vào (nỗi thất vọng...) - danh từ - sự phóng túng, sự tự do, sự buông thả -with abandon: phóng túng
abandonment	(Tech) bỏ, từ bỏ (d)
abandonments	(Tech) bỏ, từ bỏ (d)
abandons	ngoại động từ - bộm (nhiếp ảnh) (nhiếp ảnh) (từ Mỹ,nghĩa Mỹ) từ bỏ; bỏ rơi, ruồng bỏ -to abandon a hope: từ bỏ hy vọng -to abandon one's wife and children: ruồng bỏ vợ con -to abandon oneself to: đắm đuối, chìm đắm vào (nỗi thất vọng...) - danh từ - sự phóng túng, sự tự do, sự buông thả -with abandon: phóng túng
abapikal	tính từ - (sinh học) xa đỉnh; xa ngọn - dưới vực
abarognosis	(y học) mất nhận thức trọng lượng
abarthrosis	(y học) sự sai khớp
abarticular	tính từ - (giải phẫu) học ngoài khớp; trật khớp
abas	danh từ - áo aba (áo ngoài giống hình cái túi người A-Rập)
abase	ngoại động từ - làm hạ phẩm giá, làm mất thể diện, làm nhục -to abase one-self: tự hạ mình
abased	ngoại động từ - làm hạ phẩm giá, làm mất thể diện, làm nhục -to abase one-self: tự hạ mình
abasement	danh từ - sự làm hạ phẩm giá, sự làm mất thể diện, sự làm nhục
abasements	danh từ - sự làm hạ phẩm giá, sự làm mất thể diện, sự làm nhục
abases	ngoại động từ - làm hạ phẩm giá, làm mất thể diện, làm nhục -to abase one-self: tự hạ mình
abash	ngoại động từ - làm bối rối, làm lúng túng, làm luống cuống
abashed	tính từ - bối rối, xấu hổ
abashes	ngoại động từ - làm bối rối, làm lúng túng, làm luống cuống
abashing	ngoại động từ - làm bối rối, làm lúng túng, làm luống cuống
abashment	danh từ - sự bối rối, sự lúng túng, sự luống cuống
abashments	danh từ - sự bối rối, sự lúng túng, sự luống cuống
abasia	(y học) chứng thất hành, không đi lại được
abasia atactica	chứng đi lẩy bẩy, mất đlều hòa
abasic	thuộc chứng mất đi
abasing	ngoại động từ - làm hạ phẩm giá, làm mất thể diện, làm nhục -to abase one-self: tự hạ mình
abask	phó từ - (thơ ca) dưới ánh nắng, dưới ánh mặt trời, trong ánh lửa ấm
abatable	tính từ - có thể làm dịu, có thể làm yếu đi, có thể giảm bớt - có thể hạ, có thể bớt - có thể làm nhụt - có thể chấm dứt, có thể thanh trừ - (pháp lý) có thể huỷ bỏ, có thể thủ tiêu
abatardissement	(y học) sự thoái biến, Sự suy đồi ( của nòi giống )
